                                                                  =====                 ||||||||||||||                                                
                                                                  =====                 |============|                                                
                                                                  =====                 |============|                                                
                                                                  =====                 |============|                                                
                                                                  =====                 |============|                                                
                   ==                                                                   |============|                                                
                   ==                                                                 ||*============|||                                              
                   ==                                                                 |  ============  |||||||||||                    ============    
                   ==                                                                 |  ======================= ||                =========          
                   ==                             =========================     |||||||  =======================  |||              =========          
                   ==                             ===========================   |===============================    |              =========          
                                                  ===========================   |===============================    |           =============         
                                                  ===========================   |===============================    |              =========          
                                                  ===========================   |===============================    |              =========          
                                                  ============   ============   |===============================    |              =========          
                                                               = ============   |=========         =============    |              =========          
                                                               = ============   |=========         =============    |              =========          
                                                               =   =====        |=========         =============    |              =========          
                                                               =   =====        |=========                          |              =========          
              ========                                         =   =====        |=========                          |              =========          
==========    ========                                             =====        |=========                          |              =========          
==========    =========                                            =====        |=========                          |              =========          
==========        =====                                            =====        |=========                          |              =========     =    
==========        =====                                            =====        |                                   |=======                 =====    
==========        =====                                            =====        |       =======                     |=======                 =====    
==========        =====                                 *          =====        |       =======                     |=======                 =====    
==========        =====                                 |                       |       =======                     |=======                 =====    
  ==== =======    =====                                 |                       |       =======                     |=======                     =    
  ==== =======    =====                                 |                       |       =======                     |            ====            =    
  ==== =======    =====                                 |                       |       =======                     |================                 
  ==== =======    =====                                 |                       |                                   ||           =====                
  ==== =======    =====     ========                    |                       |                                    |           =====                
  ==== =======              ========                    |                       |    ========                        |           =====                
  ==== =======              ========                    |||||||                 |    ========                        ||          =====                
  ==== =======              ========                    |     |                 |    ========                         |          =====                
  ====      =============== ========                    |     |                 |    ========         ========        |          =====                
            =============== ========         ========   |     ||||              |    ========         ========        |          =====                
            =============== ========         ========   |        |              |    ========         ========        |          =====                
            =============== ========         ========   |        |              |    =========================        |         ============          
            =============== ========         ========   |        |              | *  ========         ========        |         ============          
            =============== ========         ========   |        |||||          | |  ========         ========        |=====================          
            =============== ========         ========   |     =======|          | |  ========         ========        |=====================          
            =============================    ========   |     =======||         | |   ====            ========        |=====================          
            =============================    ========   |     ======= |         | |   ====            ========        |=====================          
            ===============      ========    ========  ||     ======= |         | |                   ========        |=====================          
            ===============      ========    ======== ||      ======= |         | |                   ========        |=====================          
            ===============      ========    ======== |       ======= |         | |                                   |         ============          
            ===============      ========           |||       ======= |         | |                                   |         ============          
            ===============      ========           |         ======= |         ||||||                                |||       ============          
            ===============      ========           |         ======= |           ===|                                  |                             
                                 ================||||         ======= |           ===|                            =     |                             
                                  ===============|            ======= |           ===|                            =     |                             
                                   ==============|            ======= |           ===|                            =     |                             
                                   ==============|            ======= |           ===|                            =     |                             
                                        ||||||||||            ======= |           ===|                =============     ||                            
                                      |||                             |        ======|                =============      |                            
                                     ||          ====                 |        ======|                =============      |                            
    ==                              ||           ====                 |        ======|                =============      |                            
    ==                              |            ====                 |        ======||||        ==   =============      |||                       =  
    ==                              |            ====                 |        ======|  |             =============        |                       =  
    ==                              |                    ========     |        ======|  |||||         =============        ||                      =  
    ==                              |                    ============ |        ======|      ||||      =============         |                      =  
    ==                             ||                    ============ |        ======|         |      =============         |||||||*               =  
    ==                            ||                     ============ |        ======|         |      =============                                =  
    ==                           ||                      ============ |        ======|         |      =============                 =======        =  
                                 |                       ============ |  ====  ======|         |      ================              =======           
                                 |                       ============ |  ====  ======| ||||||||*      ================              =======           
                                 |      ===============  ============ |==============| |   ============= =============              =======           
              ========           |      ===============  ======       |||====  ======|||   ============= =============              =======           
              ========           |      ===============  ======         |====  ======|     ============= =======                    =======           
              ========           |      ===============  ======         |====   ||||||     =============                                              
              ========           |      ===============  ======         |====   | ||       =============                                              
              ========           |      ===============  ======         |====   | |=====================                                              
                                 |      ===============  ======         |====   | |=====================        ==============                       =
                                 |      ===============                 |====   | |=====================        ==============                       =
                                 |      ===============                 |====   | |=====================        ==============                       =
                                 *||||  ===============                 |====   | |=====================        ==============                       =
                        =============|  ===============     ========||||||||||||| |=====================        ==============                       =
       ========         =============|| ===============       |||||||    |        |============                 ==============                       =
       ========         ============= | ===============       |          |        |============                 ==============                       =
       ========         ============= | ===============    ||||          |        |                             ==============                       =
       ========         ============= |                    |             |        |                             ==============                       =
       ========         ============= |                    |             ||||||   |                             ==============                       =
       ========         ============= ||                   |                  |  *|                                   ========                       =
                                       |                   |                  |  ||                                   ========                       =
                                       |||||||             |                  |  ||                                   ========                       =
                                   ==========|             |                  |  ||                                   ========                        
                                   ==========|             |                  |  ||                                   ========                        
                                   ==========|            ||                  |  ||                         ========= ========             ==         
                                             |            |                   |  ||                         ========= ========             ==         
                                             |           ||                   |  ||                         ==================             ==         
                                             |           |                    |  ||                         ==================             ==         
                                             |           |                    |  ||                         ==================             ==         
                                             |           |                    |  ||                         ===========                    ==         
                                             |||         |                    |||||                         ===========                    ==         
                ===========                    |||       |                    |==========                   ===========                ============== 
                ===========                      |     |||                    |||                           ===========                ============== 
                ===========                      |     |                      | |                                 =====                ============== 
                ===========                      ||||| |                      | |        =============            =====                               
                ===========                          | |                      | |        =============            =====      ======                   
        ==============           =                   | |                      | |||      =============            =====      ======                   
                        ======                       | |  ==========          | | ||     =============            =====      ======                   
                        ======                       | |  ==========          | |  |   ====                       =====      ======                   
    ==============      ======                       * |  ==========          | |  |   ====                       =====      ==========               
    ==============      =======                      | |  ==========          | |  |   ====                       =====      ==========               
    ==============         ====                      | |     ========         | |  |   ====                   =========================               
    ==============         ====                      | |     ========         | |  |   ====                    =====         ==================       
    ==============         ====                      |||     ========         | |  |                           =====         ==================       
    ==============         ====    ============      ||      ========         | |  |                           =====         ===================      
    ==============         ====    ============      ||      ========         | |  |                           =====         ===================      
    ==============         ====    ============      ||                       | |  |                           =====         ===================      
    ==============         ====    ============      ||                       | |  |          *                =====         ===================      
    ==============         ====================  ||||||                       | |  |          |                =====         ==================       
    ==============           ================== || |||                        | |  |         ||                =====         ==================       
         =====               ===========  |||||||  |===============           | |  |         ||                =====          =================       
                             ===========  |        |===============           | |  |         ||                ================================       
                             ===========  |        |===============           | |  |         ||                     ===========================      =
                             ===========  |        |===============           | |  |         ||                     ==============  ============     =
                              |||||||||||||        |===============           | |  |         ||                     ==============  ============     =
                              |                    |===============           | |  |         ||                     ==============  ============     =
                              |                    |===============           | |  |         ||                     ============================     =
                              |                    |===============           | |  |         ||                     ============================     =
                              |                    |                          | |  |         ||                     ============================     =
                              |                    |                          | |  |       ||||                     ============================     =
                              |                    |                          |||||*       | |                      ============================     =
                              |   ==========       |                            |          | |                     =============================     =
                              |   ==========       |                            |         || |                     ========   ===============        =
                              |   ==========       |                           ||||||||||||  |                     ========   ===============         
 ============                 |   ==========       |                           ||============|                     ========   ===============         
 ============                 |   ================ |                         |||||           |                     ========   ===============         
 ============                 |   ================ |                         |   |           |                     ========                           
 ============                 |  ================= |                       |||  =|           |                     ========                           
 ============   =             |  ================= |                       |    =|           |                     ========                           
 ============   =             |  ================= |                      ||    =|           |                     ========                           
 ============   =             |  ================= |                      |     =||  ========|                     ========                           
 ============   =             |  ====== ========== |                      |     = |  ========|                     ========                           
 ============   =             |  ====== ========== |                      |     = |  ========|                     ========                           
 ============   =   ========  |  ====== ========== |                 ||||||     = |         ||                         ====                           
 ============   =             *||=================||                 |          = |         |                          ====     ||*==                 
       ====     =               |=================|========          |          = |||||     |                          ====     | |==                 
       ====     =               |==============   |                  |   ||||||||||||||||||||||||||||||||||||||||||||||====     | |                   
       ====     =     =====     |==============   |            |||||||||||=========== |     |                         |====     | |                   
       ====     =               ||||||||||||||||||||||||||||||||     |    =========== |     |                         |====     | |                   
       ====     =                                 |           ||||||||    =========== ||    |                         |====     | |                   
       ====                                       ||          |=======    ===========  |    |                         |====     | |                   
       ====                                        |         ||           ===========  |||||* ===                     |====    || |                   
       ====                                        |        ||            ===========         ===                     |||||||||||||                   
       ====                                        |        |             ===========         ===          ||||||||||||||||||||                       
       ====                                        ||*|||||||             ===========            *||||||||||                                          
===   =====                                                               ===========                                                                 
